      #   # B
### #   #   #
    ### ### #
 ## # # #   #
 #  # # # # #
A#        # #